00111110
11100010
14320010
11102410
14112010
10104011
12422241
10004001
11111111