0000000000000011111111
0000000000000010044441
0001111111111110044441
0001000010020200044441
0001022212002010044441
0001002000002010044441
0001022012020211111111
1111002010000010000000
1000101111111110000000
1000020011000000000000
1022122031000000000000
1000100011000000000000
1111111110000000000000