0111111111111111111111
1100000000000000000001
1000020100000011010001
1001111110111001211011
1121000112144440001010
1001000020144441101010
1020101010144441100010
1020122000144441121010
1010232112144441100010
1000222000144441000010
1002100010111111021110
1100101112200200020100
1100000102002011000100
0111110001000111111100
0000011111111100000000